11111111111111111111111111111111111
10000000000000000000000000000000001
10E0000000000000C00000C000000000001
10010010100100000101001000000010101
10010010010101010001001000000010101
10P0000000C00C0000000000000000000C1
11111111111111111111111111111111111
