1111111111111
1001100010001
1001001000DC1
1000011111001
1P0011E000001
1111111111111
