1111111111111
1001100010001
1001001000D01
1000011111001
1P0E11C000001
1111111111111
