1111111111111
10010000000C1
1E00011111001
1P0011C000001
1111111111111
