1111111111111
1000100010001
10010010000C1
1E00011111001
1P001100C0001
1111111111111
